R   1600   900

F    166  ,   185 ,191
C    200,236,225

NO     ./textures/neon/1.xpm
SO  ./textures/neon/2.xpm

EA   ./textures/neon/5.xpm
S ./textures/sprite/ghost.xpm
WE   ./textures/neon/4.xpm

  1111  111
 100001100011
 1002020012101
 1000100100201
10000000002001
10010000000001
1E020010021211
10000020111001
10010000001101
 111111111111