R   1600    900

F 40,    47, 107
C    200,236,225


NO     ./textures/neon/01.xpm
SO  ./textures/neon/02.xpm

EA   ./textures/neon/05.xpm
S ./textures/sprite/moon.xpm
WE   ./textures/neon/04.xpm


111111 1111
  10001000211  1111
  10201101212112021
1111002202020200101
1000020120110102001
1001000000102021021
1020011002E01100201
1120020001120020101
 112002000110102011
 12000122000201001
1100120012110020201
 110002112010001001
 102000000002120201
111012012111100111
  1111111    11
