R   1600    900

F 40,    47, 107
C    200,236,225


NO     ./textures/neon/13+.xpm
SO  ./textures/neon/18.xpm

EA   ./textures/neon/15.xpm
S ./textures/sprite/cabaret.xpm
WE   ./textures/neon/18+.xpm

111111 1111
  10001000211  1111
  10201101010110201
1111000200000200101
1020E00100110102001
1001000000002001021
1020011002001100201
1100000001120020101
 110201000110102011
 10000002000201001
1100120010110000201
 110002112010001001
 102000000002100201
111012012111100111
  1111111    11
